#WIP
#######################################
# Syntax Coloring Map For eBoard.h
#######################################

#######################################
# Datatypes (KEYWORD1)
#######################################

optVAL_t	KEYWORD1
SoccerBoard	KEYWORD1
DynamixelBoard	KEYWORD1
AX12Servo	KEYWORD1
I2CInOut	KEYWORD1
LCD	KEYWORD1
NeoPixel	KEYWORD1
RB14Scan	KEYWORD1
_servoHandler	KEYWORD1

#######################################
# Methods and Functions (KEYWORD2)
#######################################

checkIdx	KEYWORD2
checkOverflow	KEYWORD2
checkPin	KEYWORD2
countSetBits	KEYWORD2
isConnected	KEYWORD2
pingI2C	KEYWORD2
readI2C	KEYWORD2
readPin	KEYWORD2
readVal	KEYWORD2
sendI2C	KEYWORD2
setPin	KEYWORD2
setup	KEYWORD2
shiftAll	KEYWORD2
shiftSingle	KEYWORD2
writePin	KEYWORD2
writePWM	KEYWORD2
writeVal	KEYWORD2

changeMotorID	KEYWORD2
getPosition	KEYWORD2
id	KEYWORD2
isMoving	KEYWORD2
ledOff	KEYWORD2
ledOn	KEYWORD2
setID	KEYWORD2
setPosition	KEYWORD2
setPositionMode	KEYWORD2
setSpeed	KEYWORD2
setSpeedMode	KEYWORD2
setTorque	KEYWORD2
storedPos	KEYWORD2
storedSpe	KEYWORD2
storePosition	KEYWORD2


action	KEYWORD2
changeId	KEYWORD2
changeMotorID	KEYWORD2
ledOff	KEYWORD2
ledOn	KEYWORD2
changeAddress	KEYWORD2
changeModes	KEYWORD2
read	KEYWORD2
write	KEYWORD2

changeBackground	KEYWORD2
changeBrightness	KEYWORD2
changeID	KEYWORD2
changeMode	KEYWORD2
clear	KEYWORD2
drawBitmap	KEYWORD2
ID	KEYWORD2
init	KEYWORD2
lightOff	KEYWORD2
lightOn	KEYWORD2
reset	KEYWORD2
setCursor	KEYWORD2

begin	KEYWORD2
canShow	KEYWORD2
clear	KEYWORD2
Color	KEYWORD2
Color	KEYWORD2
gamma8	KEYWORD2
getBrightness	KEYWORD2
getPin	KEYWORD2
getPixelColor	KEYWORD2
getPixels	KEYWORD2
numPixels	KEYWORD2
setBrightness	KEYWORD2
setPin	KEYWORD2
setPixelColor	KEYWORD2
show	KEYWORD2
sine8	KEYWORD2
updateLength	KEYWORD2
updateType	KEYWORD2

channel	KEYWORD2
raw	KEYWORD2
write	KEYWORD2

analog	KEYWORD2
button	KEYWORD2
digital	KEYWORD2
led	KEYWORD2
ledMeter	KEYWORD2
ledOff	KEYWORD2
ledOn	KEYWORD2
ledsOff	KEYWORD2
motor	KEYWORD2
motorsOff	KEYWORD2
msleep	KEYWORD2
power	KEYWORD2
powerOff	KEYWORD2
powerOn	KEYWORD2
reset	KEYWORD2
sleep	KEYWORD2
waitForButton	KEYWORD2

#######################################
# Instances (KEYWORD2)
#######################################

#######################################
# Constants (LITERAL1)
#######################################

EagleoutIce LITERAL1
EAGLEOUTICE LITERAL1

ANALOG_IN_10_BIT	LITERAL1
ANALOG_IN_8_BIT	LITERAL1
ANALOG_IN_MEAN_10_BIT	LITERAL1
ANALOG_IN_MEAN_8_BIT	LITERAL1
BUFFER_LENGTH	LITERAL1
COUNTER_16_BIT	LITERAL1
COUNTER_8_BIT	LITERAL1
COUNTER_B_DIR	LITERAL1
COUNTER_B_DIR_PULLUP	LITERAL1
COUNTER_MEAN_16_BIT	LITERAL1
COUNTER_MEAN_8_BIT	LITERAL1
COUNTER_RISE_16_BIT	LITERAL1
COUNTER_RISE_8_BIT	LITERAL1
DIGITAL_IN	LITERAL1
DIGITAL_IN_INV	LITERAL1
DIGITAL_IN_PULLUP	LITERAL1
DIGITAL_IN_PULLUP_INV	LITERAL1
DIGITAL_OUT	LITERAL1
DIGITAL_OUT_HIGH	LITERAL1
DIGITAL_OUT_INV	LITERAL1
DIGITAL_OUT_LOW	LITERAL1
EBOARD_BLUETOOTH	LITERAL1
EBOARD_CHECK_PINS	LITERAL1
EBOARD_CHECK_PINS_PWM	LITERAL1
EBOARD_CLAMP	LITERAL1
EBOARD_COPY_AND_PASTE	LITERAL1
EBOARD_DEBUG_MODE	LITERAL1
EBOARD_DEBUG_SPEED	LITERAL1
EBOARD_GUESSPATH	LITERAL1
EBOARD_I2C	LITERAL1
EBOARD_LCD	LITERAL1
EBOARD_NANO	LITERAL1
EBOARD_NEO	LITERAL1
EBOARD_NEO_400KHZ	LITERAL1
EBOARD_NEO_800KHZ	LITERAL1
EBOARD_NEO_BGR	LITERAL1
EBOARD_NEO_BGRW	LITERAL1
EBOARD_NEO_BGWR	LITERAL1
EBOARD_NEO_BRG	LITERAL1
EBOARD_NEO_BRGW	LITERAL1
EBOARD_NEO_BRWG	LITERAL1
EBOARD_NEO_BWGR	LITERAL1
EBOARD_NEO_BWRG	LITERAL1
EBOARD_NEO_GBR	LITERAL1
EBOARD_NEO_GBRW	LITERAL1
EBOARD_NEO_GBWR	LITERAL1
EBOARD_NEO_GRB	LITERAL1
EBOARD_NEO_GRBW	LITERAL1
EBOARD_NEO_GRWB	LITERAL1
EBOARD_NEO_GWBR	LITERAL1
EBOARD_NEO_GWRB	LITERAL1
EBOARD_NEO_RBG	LITERAL1
EBOARD_NEO_RBGW	LITERAL1
EBOARD_NEO_RBWG	LITERAL1
EBOARD_NEO_RGB	LITERAL1
EBOARD_NEO_RGBW	LITERAL1
EBOARD_NEO_RGWB	LITERAL1
EBOARD_NEO_RWBG	LITERAL1
EBOARD_NEO_RWGB	LITERAL1
EBOARD_NEO_WBGR	LITERAL1
EBOARD_NEO_WBRG	LITERAL1
EBOARD_NEO_WGBR	LITERAL1
EBOARD_NEO_WGRB	LITERAL1
EBOARD_NEO_WRBG	LITERAL1
EBOARD_NEO_WRGB	LITERAL1
EBOARD_PWM_SPE	LITERAL1
EBOARD_SHIFT_REGISTER	LITERAL1
EBOARD_SPI_SERVO_MAX	LITERAL1
EBOARD_USE_RESET	LITERAL1
EBOARD_USE_SPI	LITERAL1
EBOARD_USE_UTILITY	LITERAL1
FREQ_HIGH	LITERAL1
FREQ_LOW	LITERAL1
GCC_VERSION	LITERAL1
HIGHSPEED	LITERAL1
LCD_COMMAND_BLACK_BACKGROUND	LITERAL1
LCD_COMMAND_CHARGE_PUMP_ENABLE	LITERAL1
LCD_COMMAND_CHARGE_PUMP_SETTING	LITERAL1
LCD_COMMAND_DISPLAY_OFF	LITERAL1
LCD_COMMAND_DISPLAY_ON	LITERAL1
LCD_COMMAND_MODE	LITERAL1
LCD_COMMAND_SET_BRIGHTNESS	LITERAL1
LCD_COMMAND_WHITE_BACKGROUND	LITERAL1
LCD_DATA_MODE	LITERAL1
LCD_HEIGHT	LITERAL1
LCD_HORIZONTAL_ADDRESSING	LITERAL1
LCD_PAGE_ADDRESSING	LITERAL1
LCD_WIDTH	LITERAL1
PIN_BLUETOOTH_RX	LITERAL1
PIN_BLUETOOTH_STATE	LITERAL1
PIN_BLUETOOTH_TX	LITERAL1
PIN_MAX	LITERAL1
PIN_MOTOR_DIR	LITERAL1
PIN_MOTOR_SPE	LITERAL1
PIN_SHIFT_CLK	LITERAL1
PIN_SHIFT_DAT	LITERAL1
PIN_SHIFT_LAT	LITERAL1
PWM_FAST	LITERAL1
PWM_SLOW	LITERAL1
REPT_TASK	LITERAL1
SPI_2XCLOCK_MASK	LITERAL1
SPI_CLOCK_DIV128	LITERAL1
SPI_CLOCK_DIV16	LITERAL1
SPI_CLOCK_DIV2	LITERAL1
SPI_CLOCK_DIV32	LITERAL1
SPI_CLOCK_DIV4	LITERAL1
SPI_CLOCK_DIV64	LITERAL1
SPI_CLOCK_DIV8	LITERAL1
SPI_CLOCK_MASK	LITERAL1
SPI_MODE0	LITERAL1
SPI_MODE1	LITERAL1
SPI_MODE2	LITERAL1
SPI_MODE3	LITERAL1
SPI_MODE_MASK	LITERAL1
IGNORE_SIZE LITERAL1
